iiiiiiiiiiiiiiiiiiiiiiiiiiiiiiiiiiiiiiiiiiiiiiiiiiiiiiiiiiiiiiiiiiiiiiiiiiiiiiii
#########################.######################################################
#***********************#.#***********************#.################*********#..
#***********************#.#***********************#.#...............##########.#
#******##################.#########################.###############............#
#******#............................................#*************#.#######.####
#******#.####################.########.############.###############.#*****#.#**#
#*######.#******************#.#******#.#**********#.#*************#.#######.#**#
#*#......#********###########.#******#.#**********#.#########*****#.........#**#
#*#.######********#...........#******#.#**********#.........#*****#####.#####**#
#*#.#*************#.###########******#.#**********###########*********#.#******#
#*#.###############.#****************#.#******************************#.#******#
#*#.................#****************#.###############################..#******#
#*#################.#****************#.................................#*******#
#*****************#.#################################.##############..#********#
#****************#....................##************#.#***********#..#*********#
#***************#..##########.#########*#***********#.#**********#..############
#**************#..#*********#.#*******#**#**********#.#*********#..............#
#*****##########.############.#######################.##########..##############
#*****#...............................#..........................#*************#
#*****#.#.###################.#######################.############*************#
#****#..#..#****************#.#*******#******#******#.#*****#******************#
#***#..#*#..#***************#.#*******#*******#*****#.#****#*******************#
#**#..#***#..################.#########********#****#.#***#********************#
#**#.#*****#..........................#*********#***#.#**#*********************#
#**#.#*****###########.###########.####**********#**#.#*#**********************#
#**#.#***************#.#*********#.#**#***********#*#.##*********###############
####.#***************#.###########.####************##.#**********#.............#
X..l.#***************#................###############.############.............#
####.#***************##################****#...................................#
########################################################################.#######