iiiiiiiiiiiiiiiiiiiiiiiiiiiiiiiiiiiiiiiiiiiiiiiiiiiiiiiiiiiiiiiiiiiiiiiiiiiiiiii
#######################################.########################################
#***************************#*****#####.########***#***************************#
#**************************#******#.....#......#****#**************************#
#*************************#*******#.##########.#*****#*************************#
#************************#********#.#********#.#*######************************#
#***********************#***#######.####*****#.#*#.....#***********************#
#**********************#***#...........#*#####.###.######**********************#
#*********************#***#*##########.#*#.........#*****#*********************#
#********************#****#**#*******#.#*#.#########******#********************#
#*******************#*****#**#*******#.#*#.#***********#####*******************#
#******************#*****#***#*******#.#*#.#**********#.....#******************#
#*****************##****#***#********#.#*#.#**********#..#####*****************#
#****************#**#***#***#********#.#*#.#*********#..#*****#****************#
#***************##***###***#*********#.#*#.#********#..#*******#***************#
#**************#**#*******#******####..##..####****#..#*********#**************#
#*************#****#######****###.....###......####..#***********#*************#
#************#************####.......#####........#.##************#************#
#***********#**********####..........#####...........####**********#***********#
#**********#**************#.#........#####........##.#**************#**********#
#*********#***************#.#.###.....###......###*#.#***************#*********#
#********##################.#....##.########.##****#.##################********#
#*******#.................#.#.....#.#******#.#*****#...................#*******#
#******###########.########.#.....#.#******#.#*****#.#########.##########******#
#*****#**********#.#******#.#.....#.#******#.#*****#.#*******#.#*********#*****#
#****#############.########.######...######..#######.######################****#
#***#.........#..#............#...................##.............#.....#***#***#
#**#...##.##..#..#............#......####.........##......#......#......########
#*#....#...#............................#.........##......#......#..............
##.....#...#..........####.....###......#..............####.............########
################################################################################