iiiiiiiiiiiiiiiiiiiiiiiiiiiiiiiiiiiiiiiiiiiiiiiiiiiiiiiiiiiiiiiiiiiiiiiiiiiiiiii
#######################################.########################################
#***************************#.....#####.########...#***************************#
#**************************#......#.....#......#....#**************************#
#*************************#.......#.##########.#.....#*************************#
#************************#........#.#........#.#.######************************#
#***********************#...#######.####.....#.#.#.....#***********************#
#**********************#...#...........#.#####.###.######**********************#
#*********************#...#..#########.#.#.........#.....#*********************#
#********************#....#..#.......#.#.#.#########......#********************#
#*******************#.....#..#.......#.#.#.#...........#####*******************#
#******************#.....#...#.......#.#.#.#..........#.....#******************#
#*****************##....#...#........#.#.#.#..........#..#####*****************#
#****************#..#...#...#........#.#.#.#.........#..#.....#****************#
#***************##...###...#.........#.#.#.#........#..#.......#***************#
#**************#..#.......#......####..##..####....#..#.........#**************#
#*************#....#######....###.....###......####..#...........#*************#
#************#............####.......#####........#.##............#************#
#***********#..........####..........#####...........####..........#***********#
#**********#..............#.#........#####........##.#..............#**********#
#*********#...............#.#.###.....###......###.#.#...............#*********#
#********##################.#....##.########.##....#.##################********#
#*******#...................#.....#.#......#.#.....#...................#*******#
#******###########.########.#.....#.#......#.#.....#.#########.##########******#
#*****#..........#.#......#.#.....#.#......#.#.....#.#.......#.#.........#*****#
#****######################.######...######..#######.######################****#
#***#.........................#...................###............#.....#***#***#
#**#...##.##..#..#.#..#..#....#......####.........###.....#......#......########
#*#....#.#.#..#..##...#..#..............#.........###.....#......#..............
##.....#...#..#..#.#..####.....###......#.................#.............########
################################################################################