iiiiiiiiiiiiiiiiiiiiiiiiiiiiiiiiiiiiiiiiiiiiiiiiiiiiiiiiiiiiiiiiiiiiiiiiiiiiiiii
######################################.#########################################
#......#.#........#.#................#.#.................#.#.............#.....#
#......#.#........#.#...............##.##..........#######.#########.....#.#####
#.######.##########.##################.#.#.........#...............#.....#.#...#
#.#....................................#..#........#.#############.#.....#.#...#
#.#.#########.#####.####################...#########.#...........#.#.....#.#...#
#.#.#.......#.#...#.#...........##.###.#....#........#......######.#######.#####
###################.###........#.#.#.#.#.....#######.#......#..................#
#.....................#.......#.##.###.#...####....#.#......#.########.#########
#####################.#......##.#......#...#...#...#.#####..#.#......#.#.......#
#...................#.#.....#.#.#.####.#####.####..#.....#..#.#..#####.#####...#
#...................#.#....##.###.#..#.......#...#.#####.#..#.#..#.........#...#
#...................#.#...#.#.....#..#.#####.#....#....#.#..#.#..#.#######.#...#
#...................#.#..#..##.####..#.#...#.#.....#...#.#..#.#..#.#.....#.#...#
#####################.########.#######.#####.################.####.#############
#..............................................................................#
#####################.################.####################.#######.############
#....#.#............#.#....#....#.#..#.#..#.######........#.#.....#.#..........#
######.#...##########.#.....#..##.####.####.....#.#########.#.#####.######.....#
#......#...#..........########.#............####..#.........#.#..........#.....#
######.#...#.########.........##.#####.###.##.#...#.#######.#.#.########.#.....#
#....#.#...#.#......#.##########.#...#.#.#.#.##...#.#.....#.#.#.#....#.#.#.....#
######.#####.########.#.........##...#.#.#.##.#...#.#.....#.#.#.####.#.#.#######
#.....................#..........#...#.#.#.##.#...#.#.....#.#.#......#.#.......#
##########.##########.#...........#..#.#.##.#.#...#.#.....#.#.########.#.#######
#........#.#........#.##############.#.#.#..#.#...#.#.....#.#..........#.#.....#
############........#...............##.##...#.#####.#.....#.############.#.....#
#..........#........##################.#....#.......#.....#..............#.....#
############.........................#.#....#########.....################.....#
######################################.#########################################